========================================================
|                                ==                    |
|                                ==                    |
|                                ==                    |
|                               ====                   |
|                              ======                  |
|                             ========                 |
|                            ==========                |
|                           ============               |
|                            ==========                |
|                   ==        ========                 |
|                  ====        ======                  |
|                 ======        ====                   |
|                ========        ==                    |
|               ==========                             |
|              ============                            |
|               ==========                             |
|                ========                              |
|                 ======                               |
|                  ====                                |
|                   ==                                 |
|                   ==                                 |
|                   ==                                 |
========================================================