========================================================
|==                    ======                 ===      |
|=                    ========               ===       |
|                    ===   ====             ===        |
|                   ===     ====           ===         |
|=                 ===       ====         ===          |
|==               ===        ====        ===          =|
|===             ===        ====        ===          ==|
|====                      ====        ====         ===|
|=====                    ====        ======         ==|
|=====         ===       ====        ========         =|
|====         ===       ====        ===    ===         |
|===         ===       ====        ===      ===        |
|==         ===       ====        ===        ===       |
|=         ===       ====        ===          ===      |
|         ===        ====        ===          ===      |
|        ===          ====       ===          ===      |
|       ===            ====       ===        ===       |
|       ===            ====                            |
|=       ===          ====                             |
|==       ===        ====               ==             |
|===       ===                         ====           =|
|====       ===                       ======         ==|
========================================================