========================================================
| ==========      ============                        =|
|  ========        ============                      ==|
|   ======          ============                    ===|
|    ====            ===========                   ====|
|     ==              =========                   =====|
|                      =======                    =====|
|                       =====                      ====|
|                        ===                        ===|
|                         =                          ==|
|=                                       =            =|
|==                                     ===            |
|===                                   =====           |
|===                                    =====          |
|==                                      ===           |
|=         ==                             =            |
|         ====                                         |
|        ======                                        |
|       ========                             ==        |
|      ==========                           ====       |
|     ============                         ======      |
|    ==============                       ========     |
|     ============                       ==========    |
========================================================